118,95
14,150
0101011111101101110110111111B111211102002201212221020100222111111011A1110111111110101111A1111011101110111110A1111111011110111011A1111111111111101010101010111111
1011111010111111011011011111A212002121221110111112212210201111101111A1111001011110110011A1111110101111101111A1111111111111111101A1001111111110101111110110111111
1111111101011111111101101011B112012221111222021111111012011111110111A0100011011110111011A1101111111111011011A0111111111101111010A1111111110111111111001011111111
1111101111111010111110111101A101112222221122221202122021101111111111A1111011111111111101A0111101011111111111A1111111111111111111A1110111111111101111110110111011
1110101011110111011111011111A121122221212222122011010211122011111111A1101111101101111111A0110010111011111010A1111111111001010111A1111111011110011111111111101111
1111111101111111111111111100A222111110112100021221110210210011010110A1111010011111010101A1111001111110111101A0111111111100011011A1110111101111111101010111110011
1110101111111111101111111111B211112210222220122111222112120101111100A1011111011101101110A1111011111110111111A1011111101111100001A1011001111110011110111110111110
1111111110110101111111111111A111001221101112121021021122101111111111A1111101110111111111A0111011111111111111A1110111110111110111A1101111111111111110111011111011
1111111011111111111011110101A220121221122012101110022112221100000011A1111110101001111111A1111111010110111111A1100111111111110010A1111101110011111111111010101111
1111011111001100111011011111B222111120110222111211100011222111111101A1111111111011111111A1001101111111111111A1101101111111011111A1100101101111110101011111111111
1010010111111110111110101111A001121101122212102211111222222101011010A1100111111011101011A1011111101111111111A1111110111011111111A1111111111111111111111111101111
1111111100111111111110110110B102022111221022110021111202112111011111A0111111111011101111A1111111111011101111A1011111101111101001A1010001111010111100011010111011
1111111101100111111101111111A010002222101212201002202221012111111111A1111011011101010011A1111110100110010111A0011111110111111111A1111110111111111011111111001101
1101011111111100011111011111B221012101212212022211121201122110110111A1110111101111111111A1111111101101101011A1111111111101011111A1101111111111111111101111111111
1011110101101111111111000000A102202220121212110212102202221111111111A1101111101001111110A1111111110111111110A1111011111111111001A0101111110111111111111111110111
0110110111111111101101111111A020211120221220222202010122120111111111A0101001101101111111A1111111111111001111A1111110111110010111A1101111010110111111011011111111
0000000111111011110011111111A210012111121211112202111012011100111101A1111111111011111111A0111101111100111011A1011101101110111011A0010111111111011111111111111111
1100100111111111110110111111A111001110110111011111101110011111111111A0100111011111010101A1010111111111111111A1011110111111100111A1111101111011101111101110101111
1111111111111101111010111001A111111111111111111001111111111110101111A0110111111111011111A1111111001111111011A1111111111100101011A1111110110110111111111001111111
1000011111011110111110101011A111011110111101011111111111110111111111A1111111000111111111A1111111011111111011A1111111011111111011A0111110110111110111110010101101
1111111011011111111010111111A111111111100111011011111111111111111001A1111110111010011111A1111111001011001010A0101111110111101001A0111110011111110100111111111111
1011111111111111110111111111A111111111110110111110101111111110100110A1101011110111111111A0111011111111110111A1101101001011101101A1101110111111111111111111111111
1101010111010111011010111110A011011111101011111110111111101110111001A1111101101111101111A1111111001111111110A1101111111101111101A1100110111111111011111110110111
1111110101011111111111011001A100111111110111110110011011011111111001A0111011011111111010A1001100011111011110A0110110000111001011A1001111101111111010101111111111
1011111001111110111101111110A111110111110101011111111111010111110101A1111110111100111101A1010001011111111111A1111110111110111110A1011111111111010111111011111110
0110111111111011011000100111A111111110111110111101111100011110110011A1101111111010110111A1110100011011111010A1111001110111101110A0011011111011111111101111110111
1111010111111011111110100110A101111100111111111111011111010101111111A1110011111111101111A0111111110111110111A1110111011101111111A1111110010101110101110111111101
1001011011001011111111111110A110110011010111110111111111111101120012A2110221222021201122A2101110111011111111A1111111111111111111A1110010111011110111101011111101
0011111011111111111111111001A011111111111111010111111101110110012000B1011210022211112112B2211110111111111111A1111111011100111111A1101110010111111111111100111101
0111110111110111011011010111A011110101110111101011111011110110022212A1002202121120011012B1211010111111111101A1111111110111111101A0110111111111010111111100111111
1111101111011111111111111111A011011111111101110000101101111010102211B2122222122110211222B2111111111111111001A1110110111111111010A1111010111111110111010110111111
1011101011111111110111111111A101101111101110110111111110001021010010A1211022002221122202B0211111001111111101A1110101111110111111A1101110111011111011111110011111
1111111111111111110011110111A111111111111011011111111111111102211102B1210222112211202222B2111111111111111111A1110011101111111111A1101011111110111111111010111011
0110110110101110010011010111A111110011111111101111110111011101200101A0110112220022222022A1111011010110111111A1110110001010101100A1100100011111111111101101111000
0111100100111111111111111111A101101001111111101111011111111122222102A0110102121122020202B2101111111111111111A1011111111001111111A1111010011100111011111111111011
1111111111101111011101111110A111101111101001012112121122010212222220B2222222202220222000A2120202202201220112B1112001111110110110A1111011001111000111111111100001
0111111111101011101111111111A011011111111000122111202112101220200022B1221222220212222201B0210112211201022010B1121111111100111111A1111110001110101010111111111111
1101111111111011111111101111A011011101111111101212220212222222221120B2222221122221002122B2122111200012222101A0111110100111011001A0100101111100111010111111111110
1111111111110111101011111111A111111101101101112111202112021201020022B2222222222221202020A2101102212222121100A2120111011011111111A1111111111110011110011111111111
1111001101111111110101111111A101111111111111001102011020202110222022BBBBBBBBBABABBABBBBBB2221012212220201022B1222101101111011101A0011111111111111111011111111111
1011100111101111101110010001A1111100111011100201102022222122222201202222222201122002022122012122211121120120A1012111111011110101A1111110110111101110111010101110
0111111111111111101011101111A1111110111111101112222211222122022022212202222222222122221002222122201122201211A2220211111111111111A1100111111100111110111111111011
1110011111111110001011001111A1111111111011111212111222122000122202202221222122222212222222102110212110212211B2112211111111101110A1101011011110111111011111111111
1011001101110001110111111111A1001001111111011112112100112202222222122202022220222202022212212222012010121222A2111211101111001111A0010011111101111111000111100011
1111111111101101001101110111A1111111110111110222211221011222121212220222222222222222202222221211021012221121B2120210101101011011A1111011111110111111010100011111
1111001011011011101111111111A1111111111111111012022022202202010202202222022222102210222012011021012010212122A1012000011011100111A1111001111011010110111011111011
1111101101111110111111111111A1101011111111111211122002122220221022202202222120222120202222211111221211101112A2110211111011111110A0110111111100111111011111101010
1101111111110111111110111101A1111111111111111212102120202222202212020222221122122222220220201222212122020021B2201211111101011111A1111110111111111111101111011111
1101011111111111011111111110A1111111101101110211021111111212221100222222222222220200202122222121022112110101A2222110111011011111A1111101111111111111100111111111
1111111111110111111111101110A1111001111011111202121121001122202122202202220221021022222222200101222122112110A0121211101101110111A1110111111011011111111111011111
1101111110101111101101011111A1111111011111100112212210022220222202220102202222222012220212021121012020022222A2221111111111100111A1110011110110111111111111111101
0011111111111111110111101001A1111111111101110100102101222220222211222022220200220222022220021220002121121112B2002211110101111111A1010011111111011111111111011111
1111101111110011111101111111A0111111111111101022201101002221222000122222222122222220222102021202221121211111A1102000111011111110A1100111111011111111110111011111
1111101110011110111111011111A1011111111110111211222112211101222202222220222220001022022222221221111200210102A1102001111100101111A1111011111111111111011111110101
1101100101111010110111111101A1111001111110101210102020121211221020202222222222220222222222222210212001212212A1212211111100111101A1111111110111101101111101111111
1100011011111110101111111111A1111010101111010222121122112221020222222222222222220222022212212221110220102101B2010101111101111101A1111111111111111011111111111101
1111011111111111001101001101A1111111111111111220101010221212212122222220222221202220220202211010011212011002A1021210111000111000A0101111001111111011000111111011
1111110110111111011111110111A1111111110101101121120112212002222222222222222222012002222200221201121202111220B1121200111111011111A1011011110111111101100111100011
1111111111111111101011110111A1111011101111011202222121212102022212222222222122010202200202222221011121121122B2212211111111111111A1101111111011111011101111111010
1111111111111110111101111111A1111111110110011122ABBABABBBBBABBBBBBBBBBBBBABABABBBBBBBBBBBBBBABBAABBBBABBBBAAB1121111011101111111A1100110101100111001101110110111
1111001101111111111101111111A1110011101111101211A1011101202221221222222012222201102222220121022110212102122222111211100111111110A1111110101111111001110111111111
1101110111011111110110110110A0111101101111111021A0121220012202222220202221222122100020222022222201220111120112111111011011111010A0011111111101111111111011010011
0110111111111111111011110110A1011101111101101010B2220122211021222210102122020122222220022222222122222122222102102111110111111111A1111111101111111111111111111111
1011011101111101011111110111A0111110100100111021B1111121220222102222222110221122022222221022202022220020121211121201011111111101A1111111001110111111011110111111
0111011111111101111111011111A1111011111111111111B2222112200222022102222222222201020222022222212122221122112201201101110101111110A0101111110111111110101111111111
1010110111111110111001101111A0100110111111110221A2112122121221202221202220222220221200202212222120121022120211121111111111101111A1111111101111111110111111100011
0011111111111111111110111111A1111011111111100101A1011011100111110002120200011200002202121112101101011111010111111112200222012001A0012221100122012211111011111101
1101111111111100111110010011A1111111011110111111A1101111110111102221111111211112022220211012110111011101011111011112101221110112A1221122212102101011100111111101
1111111001101111111001111111A1001011111110111100A1111111001111010212202001202221212212210121220101111011111111011111111122122102B1210101210210121110111111111101
0111111111110111111111111111A0111101111111111011A10111111111111112112112112201220202121101110121101AAAAAAAAAAAAAAAABBBAB12222122A1210120212021211111110110111110
1111111000101111101101011101A1110111101011111010A01111011011111012010111121211011221121121221221110A1011110111111110201B01212210A0122122202110210201110111101111
1100111101111100111111110111A1111101111101111110A01111011101101101201100200022112001111022001110111A1111011111111112202B10212112A1011212222221012100101111111111
1110010011100011001011111111A1111111111011111110A11111110111111122022212211201012022102022112221111A1011111111101100221B12212210A2011122222020102111110000111001
1111011101111111111011101011A0111101111110111110A11111111111110111211111022012112011221221112121111A0110111101111110211A11212221B2212202100212120211101011101011
1011111111111011111010101110A1111111111111111111A11011111011111121112101212212200220112211222021111A1111111111011111212A12121101A1012021221210220111111111011111
0111110110111111111111110111A1111011111110111111A10101101110011021110101111112002001210001112121111A0111001111111112211A20122212B2212211222222210211111111011101
1001111111110111111111011111A1111111111011111111A01111111101111122110020111221121021002111112221111A1101111111111012001B12112110A2121001212112100210111111111101
1110110111110011111100000101A1111110112121201121A22021200111011021222112211122011112012121122221010A1111011010111111021B21022012B2121012212022202211101111111101
1111011111111011010111101111A0111111011101010002B22121120122022220222221012222201202121210121211111A0101111100110011211B21021221A2112221212211112101010101111111
0111011111111101111100111111A1110111111201111122B22121112211021122112211212200211122211021222111111A1111101111011112221A01210122A2221121201101102111101111111110
1011111111011110110101111011A1100111112111110110B21122102021111112022011101110011111101011010111011A0110111111111112100A12112022B2220122212220200111111111110101
1111000111111111111101111111A1101110101020111121B12102221211112100211111011111110111011011101111111A1001010111011112200A22101222B0022222012022221200111110111111
0010111110111111111011111111A0111111111221212111A20112222202211000022111111111111111111101111110101A1111111111011010122B12000110A2200211221121021110101110111111
0110111111111111110110111011A1101111112212211221B22121011202101110111111101111111111111110111111010A1111000111111102002B20001122B2211212120202121110110110001111
1011111111111111111111111011A1111011102211121101B20221100211101022011001000111101110111110111111111A1101111101011011112A22121201A0222112211222122211101111111011
1111111111111111111111011101A0101111112012221102B21122211112022211022111111111100111101111111101111A1111110111111012221B01122212A2221222121122122111111011111101
1111101111101111101111111111A1101111111212222211B02011111121102222211111011011111111101110101111111A1011111111010111221A11121121A1120102221222221011111111111100
1111001110100111111111110111A0111110110121022221B12010122212212210211111111111111111010110110111101A1111111011111111121A22001022B1212122120102012011110111101101
0111111111111001100011111111A1111110111222112122B11022212112111121220111111111011111110001111110111A1111011111101110111B01121122A1200211022220222111110011111010
1111111101101111111110110111A1101011101201121020A20021212111222021121011111111011101101111010111111A1111111111101110210B20212122A0002122212020120011111111111011
1110111111110111110011001101A1111011111121101122B12111121211011212121111101101010111110011101111111A1111111110111111012A22222121A1212211102220211111101111111111
0111111011011011111111101111A1111110110222112012A12220111121110122101110111111110010111111111001011A0111111101111110221A22100122A2102222000211212010111101110111
1101011111111110111011111111A1111101111102212022A12212221211122122211111111101101111011111101111111A1011011101101111221A20221110A0120212222021022010111101111111
1111111101111101100111111011A1111111112221111202B01101221221212210121010011111101111010111111101111A1111111111011110111A02112122B2112222122220121011110111101110
1111111111011111111011010111A1111111111121211100B11120022111222121222110111111101111111111110111110A0111111011101111120A00001012A2220011101102211100110111101111
1111111111111110111111111111A1111101102211211001B21101122012211222220011001011110101111011001111110A1101110110111110112A02121020B0001122221122112110111101111111
1011100111011111101101111001A1111001111112011222A11111212102221200021110101111111111110011110011110A0111101011101111121B10220100B1122112100222212201111011111111
1111111010111111111101111111A1110010112220010122B11110201100020102212111111110111111111101101111111A1111111101111111111A11100111A0111111101111111111011111101111
1111011110111110101111111111A0111111112122001021B22211122112021211112111111111100101101011111110010A1111111111111011110A10100011A1111100001101001111111111011111
1111111001111101101111101111AAAAAAAAAABBBBBBABAAB22221122010221112102110110111111111111111011111110A0110101110111111110A11011111A1111111111111111101111111111111
111111011111111011110111011001111110112100212101202221110102102121101111101111111110111111011111101A1101101101111111111A11101111A1111101100111110010001110100111
111011111111011110111011110110010110112212020101211222100221122121212110111110111011111011111111111A1111111111111111110A10001000A1111110111111111111111111010001
111101101101111011111001011111111111111012110211221112211212021210210011111111110111111011110111101A1100110111111111011A00110111A1111111110101111111011111111011
101111111101111111111110011110001111111010121101212121101221222202201011001111111100011000101101110A1010111100111111111A11110110A1111000111111101111111111011111
111111011011111011111111111111111111012121020220112122021210011010222110011111111011010110111011110A1111111010011001011A10111111A1111111110110100111110111111111
111011011111111111110101111111011000112121110202211102220222210102021111100111110111111011111111111A1111101111111110111A10010111A1111111111110111111111110111110
010111111111011111011111111110111111112020012011220021111102211220221111111111110101111111111111110A1011111111101101111A11111100A1111111111100010111111111111111
111110011111111111111101011100100011100112211021121011202211202112201111111111111011101111101111111A1011111101101111111A11111011A1001111111011111011111111111011
111111101101110111111001110000111111111101011100111011110111111111111110111011101111001111011111111A1010111111011111111A01111111A1111101111111101111101011111111
AAAAAAAAAAAAAAAAAAAAAAAAAAAAAAAAAAAAAAAAAAAAAAAAAAAAAAAAAAAAAAAAAAAAAAAAAAAAAAAAAAAAAAAAAAAAAAAAAAAA0101111010111101111A11100011A1111111001011011010111111111111
10001101111011111111110111011101111111010011011101010101111101111111001100111111011100111011011111111111111111111100111A11111111A1111100011101011111111111011011
11111111000111111111111111101111111111111111001111110111010101101110111101010111001100111111111011111100101110111111101A11010111A1110010111111111101101111111101
11111111110110101111111111111111111111011010011110111101111011111111111111101111101111011111111111111111001010000111111A11011111A1110111111110111111111111110101
10111110110111110011101111111010111101111111011110111111111111111111111110111111111110111111011111111111011111111001111A11111111A1011101111111111110111111111101
11111111011111101101011111111000101011010111111111101110111110111110011111111110111111111111111111110110101101111111111A10111110A1110111111011111111001101011001
01111011011110111111100111110111001110111111100110111111111110010111111111111111111101011111001011111011100110100111111A11111111A1011111101111011111111111110111
11100111110111110101111011011101111111111111111111101111111101011111111111111101111101110111111110011110101111111111011A11110111A1111101111111110111111111011111
11111111111011111110110011110111111111011110110111101001111110111101111101011010101001110111111111110101011111101111110A11101110A0111100110111111111111111111111
11111111110110111100101110111111111111101010111011111111101001111110111101111111100110111111111111110110111111111111101A11101111A1110111111110001111111111111111
11011111111011101111111101111111111111101111101111001111111111111100100111011111110101111110111110111011101011111111110A11011110A1111101101111011111111101111101
