3, 113
117, 25
222122222112122110122B2211000111111111101A11111111111101111111011111000111A1100110111011110011A11110111011101101110112112210121210221102A10211211121110110111011
212211022111202211220B1212111101011111111A11101111111111111011101111111011A1111111111111111111A11111101111011110111111222021121121220212B12112102011111111111111
211122222120212121102A2022110000110111111A11111111110111111110011101111111A1011011101111111111A11111101111111001111110212202222112110121A22221021020011111111111
120000112121002110022A2112100111010111111A11111111111011111100101111101110A1110111111111011111A11000011111111111110112201122111201102121B22201100101110111110110
212122011222102002000B0012111011101111111A10111101111111101111111111011111A1110110011111111111A11111110111111111110111212222212220210022A02122111221111110110110
222222222012111122112B2200111011111111011A10111001110111010011111001111111A1110100111101111011A01111111101001101101010222222120102212121B21211212201111110100111
111022210111202211122A0211101001111011111A11111111101011110110111111111110A1011101111011111110A10100011111111111111110111111101212211222B22111012200111111111111
101110211221122211020B2110110111110110111A10111110001111111111110111111110A1111011111011111111A10110111101100111101110010201122200111112A12121211001110011101111
122212122021022210222B2110111111010111101A11111110111110101111111111011110A1111110101111111111A01111011101101100111111020220221110122202B02122210221101111111111
112221121210100221122A1220110011111100110A11111011110011111111111111110111A1011001110111111101A10011101011110110101010212010120211121222B22021111201010101001101
011010100212202110212B1022011101011110110A01011011101111111110111101111011A1111101110101111111A01111111111101111111102011222210212222220A11112021111111111111111
112220211022211022220A1120111110111111111A01111101101011111110011111011111A1011101101111011111A11111011100111111111012111122220121111212B11220112101110111101110
112001201112222012212B2221010110101111111A01010100101111101111110111101111A0110111111111111111A11111111111011110010010102202122112121002B22210111210110110111100
121020120222121000211B0011101111111100011A11111011111111111010111111111111A1011010101111110111A11111110001111111101111211012220221211222B02020121021111110111011
210020022111112121212B1122111010111111101A11011111100110111111010110001111A0111101101110111111A11111111111110111111102021211112122011101A02001222211111111111011
121111122021102200111B1012110101111111111A11110101111011111111111111111111A1001011110111111101A11001101111101111111110110101101111111111A01010111111101111101110
221111212021022002200A2211101111111111110A11111101111111100111111111111110A1111100111111100111A11111111011111111111111110111011111110111A11010111111011110010110
210111102212111211102A2221111110010011111A11011010011111111011101111101111A1111001010111100010A11111001101011111111110101111111011111101A11111111100111111111110
210220222012212222122A0111111101011111111A11101111111101111111111111111100A0111111110110111011A11111111111100101111111011011110111111110A10101110110111011111111
100210222201212220201A2212111001111111101AAAAAAAAAAAAAAAAAAAAA010111111111A1010111101111111101A11111111111111101101111011001010111101011A11011111111110001111110
212122011201102121212B211210111001111111100011110111110011011A011111111101A1111111111111111111A11011111111111110111001101111111001111111A11101110111111111110111
122222221100211112100B012211111111111001111101111111011101111A011010111111A1101111111010111111A11012022210022221121222002021220221111101A11111110100111111011111
212120212012122112221B022111111111101111111111111111111011011A111111110111A1010111110111111101A11011022122222212112121122220200121111111A01111110110111000011101
220122221211221112111B111211110111111111111101110111111111111A111111011111A1111101101110011110A11112012211121111202111122102122110111111A11011111111101011111111
002222221010201110202B120011111111111011110111101010101010111A011111111111A1001111111101100101A11111022122222021201222001120100221110111A11111111110111111101111
212222011222111012012B000211111011111001110111111011110101100A110111100111A0001111111111110111A11110211202121211211112122121212111111111A11111101110110111111111
112122002122211221012B222211010111011101111011111111101111101A011111011101A0111010110011011101A11111002121101220220101211221121101101001A01010111011111100111101
022211012012122012202B210011111111111011101111111011111111110A111101111011A1101111111111111111A10101221122221111222112212212201221111111A01111011110011111111110
211210111120211022212A121001111110111110111111011011111101111A000111111111A0011111111110111001A11012102201212102110011120122111111101010A11011111010011111111110
110001111111001111111A111111110110011100111110111001011111101A111111111111A1101001111111001111A11100111011212122001102100202102111101011A11100111111011101111011
111111111110111111100A111111111111111101101010111111001110111A111011111101A1111001111101111111A11011101121200211111011212222012200111110A11110011111101101011111
111010101111111111110A111111110101111111101100111111101111101A111111111111A1010111111101111110A11102220111102211202020120110212201111101A11111111111101111111111
110001111111111111101A111011111111111110111111101111111111101A010101111100A1111110111110011111A11112122111111012011122120212101221011010A11111111111111101101011
110010111111111111001A111011111011111101111111111111111100110A111101111111A1111111111111111111A11102221101102122011010222222121011111111A11110011111000111101010
110111111101011111011A001101101110101111010110101101011111111A111111010111A0001111111010111111A11112111021222212022211110122120221011111A11101100111110010111111
101111111101111011101A111011110101111101110111111011110111010A111111101110A1011111111110111101A11111120022122202102212122211201111111111A01110111111111101111010
111110110111110111111A111111100110101111111101011111111001110A111111011111A1111111111111111001A10100111001121222212210222012220021101110A11111111111111111111111
111111110011111101111A011111001111111111011110111111111011101A111011011011A1001111011101101110A01101212111222112021011002220111211110111A01111111101011110101111
111101001101001110110A111111101111111111100111111111011111111A110110111111A1011111011110110110A11111111112121120211222121120112111111010A01111111111111111110101
111101111111111111101AAAAAAAAAAAAAAAAAAAAAAAAAAAAAAAAAAAAAAAAA111111111111A1111110111000011111A11110021201121020201200211011201211111111A11111111111011111110101
01101111111011011111011101111110111111011111111111110110111011011111011111A1011010111111111011A11012022211211002201211010221112210101111A11111101101111011111111
01111111111011111110111011111111101010111111011011110111111101001011011111A1111111111101111111A11111120212122212222111121220002220111111A10111111010111011110111
11111111111111101110111111111100111111111111111111100111111101110111011111A1111111111110110111A11102102221211212121111201222122221111111A11111101111101111111110
01111111111111111111101111111101111111110011110111001111101011011111111111A1010111111111110111A10101221110121201010210110122111111111110A10111111101111101011101
11101111111101111111110111011111111100111110100011001110111110111111111110A1111111001111110001A11101210221022221220212110222012200111011A11111011110111111111111
11111111111010010111111111101110111111111111111011101111111111111111111111A1001101111111110111A11110210102100111212210211200102120111101A11111010001011011101111
11111101001111111111011111110011101110111111111111111101011001111111111111A1111111111111111100A11011222121111021102210212110100220000011A11111111111011011111111
11111100111111111011111001111101111111110111101001111011011111011111011111A1011111101111110111A01111221110020110120221200021222111111011A11110011101111110111011
11110111011111111111111111101110110111100101111101111111111011011001111110A0100101010001111010A10111210222111200212102000022111111110011A11001111111110001111111
00111010101101111111111111111111111111001111111111111111111111111011101111A1101110101111101111A11110112012000212022110210021212121010012A22002022220201100101111
01110111111011111001111111001011110110111111011101111111100011111011110111A1101110101111111111A11112110222220201111222102210202221010210A21211121102211001101111
00101110101101111111111111111110110101110110111101111111111111111111111111A1111111011111111011A00111111110111101111110011011202102102120B10111211022211111101111
01111111111100111110000001110111101101001111111111011111101001110111110000A1111010000111110011A01111011111101011111110111212211122202021B21111010102101101111101
10111111011011111111111111011010011111111111111111111110101111111011111011A1011101111111100110A11111111111111111111111121200211112001210A12121212111201111111111
01111111111111111011010110111101111111110010111100111101001110111111111001A1111111111111011011A11111101011111011011111100022112020022101B12001212220111110111100
11101111101111101011011111101111110110111011111111011101111011111111011111A1111110111111011011A01101001111111101111010100121100222102212B00110011100011111111001
11101111111011111011111110111111111001111101111111011111111110110110110110A1101111111111111111A10111111110010011101101102012122112211110B21222112221211111111001
11110110011111100111111110111110111111001011101111111111011110111111111111A0111101111111110011A11111111111011111111100121211120001212121A02202020122211111111111
11101101110011101111111011111110111111111011111111111110011101101110101111A0111111111111111101A01111111111011111111111122012011120122111A22011100221111011111111
00110101111111100011111111110111110110111111100101111100111111111111110011AAAAAAAAAAAAAAAAAAAAA11101011100111011111011120020022121010001B22111202010101111101111
1111110111101111001110111111011111101110101111010001111111111101001111110001010111111011110111101111011101111011111111121001111111121120A22111111212210111111111
1111011111111111101111110111110111111111100110111110101001110100111101111111111111111011110111111111101111111111101110102022001112212122A10022110122001001111111
0111111111111111110111111111111111111111111100111101111011111111100111111111111010111111111011111110111111110101111101102102122102102222B01221211011111011110011
1001001111101111010111101111111111001111011111110011101111110101111111110011100111110111111011011011011110110111110111122112112111102211A10110211221211110101111
1111111110111111110101111011111111111101111011111011111011001111111111111111011111111100110101111111111100110110111011100121112101001211B02001101222111011101111
0111110011001111111111010111110101100111111101110111110011111111111111011001101101111111110111110111111111011111101111120002222120222112A21021112112210111111100
1111111111100011111101111010101111111000010111011101111011011101111111111111101111100110011111111111111111110101110011110121122121121020B01120111222211111111101
1111101101010111011100011111011011110011111011001111111101101101111111111011111101011111011110111111110111111111111111112211021121222022A12202211112101111111101
1111110111111101111111111111111110111111111111000111001110011111110111110100110111111110101110111111111111111110111110111212210221001201B12121020111211111110011
1011110111111111111111110110011111111111111111111110010111111011010110110101111110101111011111111001111011111111110011122212111221211021B00100212112211111011111
1110111001111111110011101011100110111111111110111111011010101101010111011111111111111001111111101111111111100111110101102212122210010221B22201122211111011111101
1111111111111110111111101100110101101111110111111111111111111101010110110111011111111111111011110101111111101111111110122222112220121222B01211122122111101001111
0111101111010001110011011111111011111111111001111111001110101010111011111110111111101111111111011111101010110101011111120111220221202111A21220210011201111111111
0111111111100111011111111111111101111111011111111111001001111110111001101101011101111111111110111110111101111111011111121101111101110120A22012212102122111221201
1101111101101111110011111110011011000101101101111110111111011101110111101101111111110111011100001111111111111110111111102011201222222121B22210201120200112211111
1111101111111101111111010110101011111111111011111110111111111011011111101101100111011111111110111111011100011110001111122120222012221102B21222220020211102202111
1001111111110110101011111001111110110100111111111111100111101111110111110110001111110111101011110011111111011111101111122222200212112221A11211122222221212112211
1011111111011111111101111111010111011111101011110110010111011100111110011010111111100011111101111101100001111111101111121221111121002200B11002220220012210222221
1010111111111111011111111111111101110111010110111110111101111111111111111110101110111111110111110101111011101111111110112102222121122021A12012222212222222200122
AAAAAAAAAAAAAAAAAAAAAAAAAAAAAAAAAAAAAAAA011111111011111111100110101111110111111011011111111111111111111111110001111110110111111011111011AAAAAAAAAAABAAABBAAAB110
001111110000111111111111011101111111111A01111111111111111111111111110110111111111110111111111111111011111001011110111011110111011111111111101222202122011121B102
011121020222111111011110101111111111111A11110111011111110101101111011111111111111111110110111110111111111110111111111101011111111111111111110121221120212120A222
102100212121122111101111100110011101111A11111102211222122212222121212221201111111111011101001111111111100110011111111111101110111110111111111111120222201002A012
121202111121211211010111110111111101111A00122020221121220120212122101111201111110111101110111111110110110111011111110111111011111110110111011221210001121201A202
111121012100121111110111111111111101111A11110222110222121210222112222220011111001111111101111101111111111111011111111011011111101111111111101122211121122212A100
012002201200202100110001011111111110111A11122211212111111121201121011110101111111111111011111101111101100101011101011110111110001111110111110102111220110111B021
012222102222101210111110111111101101111A01111110112102201010222122020120011111011111111101111011111111111101111111111111011110111111011001111011111011210221A201
211112221211122011010111011111011010111A11021012211211202222100102122222211111111100111100011011010011111010111111101111111111101010111101111210011201201112A122
101222111211221201111111100111111111111A11112222101121100110020012002221211101111100110111111110010110111110111001111111111111001110110111011111201212120121A100
021121211211121201011011110111011110111A11101112200211220102222122202120211111111111111111111110111110011111111111111111011111111111101111000201121211020100B111
112102202220222110111001111111111011111A11112102222101101122001101101021101101111110101111110011111010110111010111111101111111110011111101111112212221001021A202
101101120211122201111111111111011111111A01111212011100020022222221212112211111111111111111111111111011111111100011110111010111111111111111101211212212212221B102
012110022222221211111111101101111111101A11121221111221210211111222211210211111111011111001111111111111111111111111100111010111111010111111011020112111122211A121
212221220000112211011111110111101111111A11112200210110122212112222222222111110101111111001111001111111111110100111111101101111110111111111111211112122210221B101
012222222222221110001001111111110111111A11111211121200102122202220200011011101111111100010111111101110111110111011011101101001111110101011111211122221211221B121
122010210211100211111010111111111111111A11112212202021011111202111212212111011111111011111111111110101111110101111111110111011111111111111100122121121110120A012
101021222112101211111111101110111111111A01110002001212221110121012222222011111011111101110111111011010010101111111111110111101011111111101111221012102012110A220
112220111212201111101011111011011111110A11120122202121121201222202222111111110101111001111101111111111110111111101011011111100011111110111011111212021102112A201
210222112012211210111111000111111110001A01001222202100122111221111122112211110101111110101111011111111110111011111101011110111101111011111111101020021202110A122
010111212122022111111101111111101111101AAAAAAAABAAAABBAAABBBABBBABABBBBAAAAAAAAA1111110101110111111111111011111100111111101101111111111111111101111221111220A122
1012111201121212011110111001101111111111110222222221102011201022022220212101011A1111111011111111111112101111101112100201212122210211111111111011212012011121B202
1110122012011020100111111010011011110010101021201121212012222011122212012110101A1111011111111011111112112222122102201211010222102110111110111210112100101101B212
1100210122121202101111011011111101101111111221122112102010111212221202120111111A1111111111110101111112212221022111121102221122102001111010111102212221202201A011
1011011121211112111111111111111111111110111221021201001011012112212221111111101A1000011110111011110122211001012122122220022021111201111100111011111110111111A111
2110222211121001001111001111010111111100111011100012111012012020111010222111011A1101111111010111111012111120101112012222121211220101000111111111111011110111A111
0122100102112110101111111110011111111111111222202212112102212221112111202110111A1110111111011101011121220000121112101100211122211211101101111111111111110100A110
2101201210122011111001101111011101111100111001210200121220222122011111012111110A1111111111111111110121100222222120220111110222222110111011111111101001111111A110
2011222220120001111011111011001111011111011221210212002012112222201200102111110A1001111100110111111102121121221022111211210212201111111111011111010001001011A000
1121111101122111111111111111011001101111101012202111121112111221102122211111111A1111111011111011111100122222222112022111201022221111111110111011110011110111A111
0102222112220011111111110111111110001110101211121121221122111212212121220011110A0101111000111111111122111222112200120111101102111211111011110110111111110111A111
1122121111222211100110111111110111110111110012221211221110212121121122011111111A1111111011111101111100001120112222112201202122112210111110110011101111111111A111
1111111111111111110111111110111111011111111121211011120111122220202210002111111A1111111011111111111101211200220210221121120121122210111011110111100111011101A100
1111111101111111101111111111111111110101111100111111110111111101011111111111111A1111110111111010111122212110021222120101112222101101111001111111111001111111A010
1111101111011111111111111011111111101111011111111011010110101111111111101111001A1110101111111111111110221122001120122121121111021211011111111111001111011111A111
1011111111111111111111111111110110101011111110111110011101101111111111111110101A0110101111011110010112211112001122222001021221222211111101111111011111001011A111
1110110111111110111110011111111101111111111111111101111111111111101110000110111A1110011111110111111011112201000221221221110122212201110101111111111111010101A110
1001111001111111011111011101111101111111111111111011110111101011011111111111100A1101111111111101111122022121112212012122120202112211111111111111111111001101A111
0111110111100111011111111111110011111111111111111111101111111111111111111111011A1011111110110111111012212001121111001112110021200211110111111111101100110100A001
1111111101110011111111110111111111111101111111101101011111111111101101101110010A1111111111111011111021111111222012002011102110022200111111010001110111111110A111
1111101111101111110010111111101011101011111011111111101110010010011111111110111A1101110111111101110112002221212120120200011202210110111111111111111111111111A011
