116, 127
98, 9
11101111011111110101111101111111101100011111010110111A10A1111011111010011100111111101100010111111110011101111110100111111000111110011101011110111111101A11101101
11101111101111111011110111111111111111110111111111011A01A0111111011011111111111011111111101110111000110111111010011101111101111111101110111010011111001A01110011
01111110111011010111111110110101111111111111111111010A11A1111111111100111111111111111111111101101110111011101111100111101111101111111111110001111101111A11011111
11111110100010111111111101111111111111111011111110011A11A1111111010011111111011111101011111111111111111010111110111001111111011110101011111010111110111A01111011
10010111111111111111101000110001011111011011101011111A11A1101111111111001101110100011111111110111111011111100011111101111111010101111100011110111111111A11111111
AAAAAAAAAAAAAAAAAAAAAAAAAAAAAAAAAAAAAAAA1110111110111A11A0111111111001101101111001111111111111011111011111111100111111111101110101100011111111111111111A01101111
111101111101111110111111111101010111101A1111101111111A10A1011111111111111110111101111111111111111010110111111011011111111111111111011110011100011111111A11011101
101111110001110010101111111111111111110A1101011111111A01A1111111111111111111011111111111111111111100111111011010110111111111111111111011111111001110010A10111100
101101111111101101111111101111111111001A0111111101111A11A1111111111111001111111010001110111011111101111101011111111111101111100101110101110110111110111A11011010
111111111110100111111111110110101111111A1111111011111A11A1010111111111111111111111100100011111010011111111111011011000011011101101110001111011111111000A11110100
111010100111011111010011111111111011111A1011100111110A11A0111111111111111110011111011011111111110111101111101111011011110111011011111100111111111111101A11010110
111111111100001111111111011101110110111A0011011111110A11A1110111011111101101100101111110111111111111011111111111111110011111110111111111110011111111110A10111011
111110111010111110111110101111110001110A1111111011111A11A1111111011111101111111110011001011110111110110111111111111111010001011111011011111111110001111A11111111
111222212112212221011212222201110001111A0111111111111A11A1111101011111111111111111110010111111001011110101111011111110111101110101101111111111111011111A11111110
111121011220222121122202101220002101111A0111100111101A10A1010111101111110111011110111101111111101111101011111111111111110101111110011011110111111111111A11011111
110222100010212112112222101122201111111A1011011111101A11A1101110111101111110011111010111111011111111110111111111010101011111100111011110110111111111111A11110110
101212220002110121221101122022012111100A1111011111111A11A1110111101111110110111111101011111001111111111000110111111111111111111001111111101111111110111A11111011
111011101120111112112202211211002111111A1111110101111A01A1111011101100100011010101111111001110111111111111011011111110111111110111101101110101011011111A11011111
111001111102201101110012212011112011111A0011110111111A11A1111110111111101111111111111111101110111110111111111111111011111011111101111110110101101101111A10111111
101122212211010222112222002202021001110A1111010111111A11A1100111111111011011111111101111111111111011011010011111101011111000110111011111101101101111111A11111110
111222222101110120021212111121022011111A1111111111111A11A1001010101101111110111101111111001111101111101111110101110101111011111111111110111110111001001A11111110
111212111221010221211121020202111111101A0001101111010A11A1111111110011110111111111111110111111111111111111101111111001011111111110111111111100111110111A10111010
111202212112201111021111222121200101111A0111101111110A10A1110110110011011101111111111111110111111110111101101101111011111011111111111010101111110011110A11111111
111200212112011211111010220021102111010A1111111111111A01A1101111111010110001111110111011101111001110101111111011111110111101100100111111111111111101111A11111111
110111210211010101112221112212112101011A1011100111111A11A1011011011101111111100111101111011111111111101111111110111111111010100111011101010110111111110A10111110
111012001021221110221122222121201101111A1011111111111A11A1111111111111110111111100111001111111111111111111111111111111111100001111011101111111101101111A10111111
111022112122120121102221112211122111101A1010101111111A11A1111111111011111001111111101110011010111100111111111111111101111111110111111101101111111011111A11011110
101221211120202112211111200112222111111A1011111011111A11A1101011101110001111101111111111111110111111111111101110111111111110010111111011111111110111111A11011111
111021222211211001102202011110110011111A0101101111101A01A1110111110111000001111110110110011010101110000111111111111101111111011011101111101011101110111A01101111
111202121202021112101101221120222111110A1010110111011A00A1111101111111110111101111111001111111111110111010111011111011111111110111101101111111111110111A10111011
111211121220101020102020121002222010111A1111111111111A11A1110011111111010111111111110111111011101101111111111111011111011111111111110011011101111101101A11111010
111100121022220201020212012221221011101A1101111110111A11A1111111011111100011111100111111110111111111111111111110111111111111110111101111111111111101111A11111111
111110222201211221211212220222101101011A0111111111111A11A1110111111111111111111110111111111110111110011011101111011101011111111111111111110101111001111A11111111
101211121212012210010201212001110001011A1111111111101A11A1111111101111111110111101101011111011111111111101101111111000011110111111111011111011111011010A11101011
111102211102101202021011220222022111111A1010101111111A11A1110111111111011110111111111111111111100111111101011101110010011001111011101111111111110110111A11101111
111112021212202102220110021222101111101A1110111101111A11A1110101011111111011101011111000111011110111111010101111111111100110111111111111100111111110110A11111111
111221112020202111112121112210112111101A1110010011111A10A1111111101101111111011011111000111001111111110111111100011111101010011011011000111111111011110A11101101
011111021111022112201122222220012111111A1111111111110A01A1101111111011111101011101100111111011111111011111111111011101101110110111111101111111111011111A11110111
111022202220021011111212221212202111011A1111111111111A11A1101001001111101111111111011111111010110111110111111111111110011111111111110111110110111111111A01011111
110111212111012001121122210122012111110A1110011111111A11A11111111111011010110011111111111001111011111111111111111111111111010111111AAAAAAAAAAAAAAAAAAAAA01110111
111101220221000121111121002212210111101A1000110011011A11A00101110111110011111110110100000110101101111111111011100101001111101101101A0110111011111100110111011100
111122121011111022011022001112012101011A1111010111111A11A11001111111011110101111111110111111111111011101010100111111111111100111111A1111101110111110101110111011
111121110211011220210022110212111111010A1111111010111A01A10111111110110110111110111111111110111001111110101111111110100111111101111A1111111011111010111111111110
101111101011011111111110111111101101011A1101111111111A11A11111111101111101111111111110111111111101011001111011011101111111011101101A1011101101011110111100111101
111111001010111111111101011110001111111A1111110111011A10A11111101111001110110101010001110010111111111111101011011111111110111110011A1100110110111111111101111000
AAAAAAAAAAAAAAAAAAAA1111111001111111111A1111001001111A11A01011111011011001011111111011111101110111011101110111111111111110111011011A1111011011101011111000111111
0100011111111101001A1111111110110111111A1111111111111A01A11011001001101110101011111111110110010101111100101110111111111111111011110A1112111101222221221200220112
1101111011111111011A1001111111111101111A1111100101111A01A11111010111101101011011011111111101001111111111111111111010111011111111011A0202011222021211112002122202
1110101111010111111A1111111011111101111A1111001100111A11A01111111011101111111100101000110100110111010111111101010110111110110111111A0112221122102000111212212212
1101110011111110111A1111111111110111011A1111111111111A11A01011101110100111011111111111111101111111111111011111111111111100101000111A1100121122211022022210221112
1111110111111111111A1110110110111111101A1111111111111A10A01111011111111111110111101111011000111111111111111111101111101110110111110A1211112111102212112111121111
1111111011101111101A1101111011111111011A1111111111111A11A01011111111111111111111111101011101101111110100100110011111110111111111111A2222001212212111022121001011
1111011110100111110A1100011101101111111A1111111010101A11A11101111111111001001111111111111111111111101111011110111101111111111111110A2222222212222011220111112121
1111011101011011011A1101110110111110100A1111111101111A11A11100111011111111111111111010111101011110101111101111110100011111100101110A2210210112222010110211111101
0111110111001111111A1111101111111011111A1110101101111A01A11111111110010111111111111111111011111011111111111111111011111111111111111A2001122221222000221121221100
1111111101101111111A1101111110110011111A0011111111111A11A11111101111111111111100111011111111111101001111111111101111101001111011110A0020212011122222112122022121
0011111111110110111A0111110111111010110A1111001110111A11A11111111111110100001011110111111110100111111111111111111101101111111110111A0122212211111222122210121012
0111111111011110100A0101101101110010111A0111110111101A11A01011011111111111111111010110111111111011110111111111111011111110001101011A1122121201020102111100211211
1111111111011111101A1110111111111111111A1111111101011A11A11111000101111111110011110111011011111111111111100111011100111111111111001A1222222022220112221221221200
1111111011111011111A1111111011101111110A1111111011111A11A11110100111111111111110110011011011111111010111110111111111011100111101111A1121110102211202211121222211
1111111011111110101A1110110000000111011A1111111111101A11A00011111111101101110111111111110111011111011110101111110111011111111111111A1201201012112202112111111110
1111110101100101111A1111011101101111111A1011111111111A01A11111011111110011110001111111111011110111011001110111110001111111101110111A2220221202222212001212221122
1111111111101101111A1101011111101110110A0111111111101A11A11111111111011111011011111111111111111100011111110111101101111110111111111A1121121221201002211022112221
1010111110011011011A1111011111100111110A0111111111111A01A11101011111011011111101101111111111111011110111111110111111111101011110111A1102112211012121211211112112
1011101101111111110A1111011110111111111A1101111101111A11A11101111100111111110111111011101111111100111110111110100111101100111111011A2020120221012212020112212210
1011100110011101110AAAAAAAAAAAAAAAAAAAAA1111111111111A11A11011011110011110111111111111101100111111110111111110110110011011100011100A2221122221110200122002010102
00111111110111111111110111111110111101011111101011111A11A11111111111111111111111110011011111110011011101111111111110110111111111011A1111211101200202222212102111
11011111111110111011111111101111111111011111001101111B12B02021212021110212221221212011111110111111111100111110101111011111111110111A0121102201110202112222201022
11111101111110011010111001011001111111110111100011011B10B21112212212212120222102101110110110111111101111110111011011010111100111111A0022022111222010102221220221
10111111111111100111101111010011110111101111111110111A11B11112121102222111200210211011110111111111011111111101101111011110011111111A2222111101120112220120012211
11111100101111110111110101110111011111100111111111010B21B11212111112121221020222212111101111111111111110111111111110111110111111011A0220122200120210020100211121
11111011111110100110100111111111011101111011011101111B12A12120111122211222111001011011111110110111111101001011111111101011111111111A1112211112222121021222112222
11101111111111001110110111111111100111111111010111111A00B00201202212202220222122112111111111110011111111111111111111101111001111111A0111222211022022112221011111
11111101111101111111111111111111101111011110111111110A12B22102121221201212022001002011111111111111111100111110101101101111111111111A1201122201220002112122212110
01111011111101111101111111011101111110111111101111111A12B10122200111220011012212001011111111111110111001111101111111110111111111111A2220111221111210121201012022
01011111111101101111010111111111111111101011100111111B02B22112212221221212020220202111111111111111110101111011111111100011010111101A2211211120110221000102111021
11111110111111011011011111102000121111210011111112111B20B12222121202221002111000111101111111111011011111111111101111111101101001110A1110111001111101111011111111
11110110101111111101012221200111122210121212222221111A21A20121021211202201122122102110110111111100111110100110111011111110100011101A0101101111111111111101011101
11110111110110111111001111211201211121211122122222121A01A22121212101022000121111122110111101111111111111101111111111100010111101111A1011111101011111011100110111
00110101111111001111111211222110100122222112221202021B21A201102112121010120011020221101111110110111111110011111AAAAAAAAAAAAAAAAAAAAA1110110111111110111001111101
00111110111111011111112221111112122110001100121122211B21B111101122201112202112112101110111100011111111111111111A101101111101110101111111111110111111110101111111
10111101011111111101111012211012211011102222022102121A10A222222212221212021101211210111101110111110110111111111A101111111101111101111111011110001111111101111111
11011111111011111111011221111222210110100122222222210A11B012222200112212101112012110101111111111111110111111010A101110111101111111100101011001111110110110111010
11010010011111111100101101001001021121212221022011121A10A011120211222111222111210121011111111110011110110111111A111101111111111111111111010101111100110111111110
11111111101111111111110021111202122212211211110202101B11B212212211120221011122121021111101111111101101111011110A111100111111110111111111111111010111111111111111
11100111111101011111112122211212211210211110210211000B12A222012122212211022211202211111110111011111111111011111A111111001111100110111101111111111111111111111111
11111111111110110111112021121221211122212202211012020B10A221212220022212222122112220111111111111100011101111111A111111101111101111110011100111110111111111111011
00111101111110111111112012112020211100112212111010021B02A112110220222110012112122021011111110111111111111110111A111111111111111011111011111111111110111111110111
01101111110111011011111202222211012001111201101221121A01A021212011222111122212221120110111111110111111101101110A101011111111111110111111111110011111111111111101
01110110011111111111110120211121210121110221122021211A22A110122121220211101211221210111111111111111111011111111A101111111110111111111111111011111111100111111101
01101001011111011101110022110112220202202122212202010B21A112121100121212221021201111011111011111011111111111111A011111010100111111011110111111011001011111111111
01111101112201121221210222220200022222222122201121220B20A011112212122212222112201121111111111111010111110101110A110111111111011111110111111111101101101111111110
11111101100121220121112122221221200202101112102220121A20B202220212222101112122210221111011101101101111111111101A111011111111110111110101111011111111111110111101
10111101112220211021021210020220022202201112122012101A20A212212222112210020112122101101010100011011110110111111A111011111101110111111101111111010111101110101111
11010011122100112221202221222202222121001121212120121A22B220222021010121001211121221011101100101111111110111010A111101111101011111011011111111111110111101110110
11111111111111121111221202221220212002221010221110211B02A220102120222220212112111011110100111110011011011111111A111110111111110111100110001110111101111111110111
11111101022211222022222121222221022102101011220010211B21A212111121121121000212120011011011000111111110100111100A011111011111021112201221122202112222021211110011
11001110120101211201002122111222102022111120002220220A11A111110111111111111110111011111111001111111111001011111A000111111111111122211202222222222222212022121110
11100111122121211220102222220212121222201212111122221A11A011110110111111101011111111111011100110111111010110110A111101111111221221020202022222212222022012020200
11111111011111212011122022221002220222212210211112101A01A111110011010111111011101111101011111101011111111101111A101111111110112212122222222212122221212222021011
01101111121212022002022022212220022120110120221210021A10A111011101011001111111101011111111111111111111100111111A111101111010112212220012212222210022220112221111
11011111021122122120202212222020221222221210211011011A11A101101111111011111111111111110101111111111011111111111A111111011101112102000222212201022222022220102202
11111111012211222121212222202221221202021222222000101A10A011111010011101001111111111111101111111111110111011111A110111111011112011222222120222021002202122222120
01010111122011201222112221222120022222212121022120101A11A021202110122221002102212001012211111101001011111111110A011111111110212120222210120122212211222200012112
11110110021112112120111220212111122000122010121111121A10A112121221022012101121020222111011110110111111111001101A101111111110111111111220202202011222012212122221
11111111111122121112021202122212200022012012201012111A11A021222221002201211201111012212210110111111110101011110A110111111011011101222012222202202021022222110110
10111110112102220001110222212210022212210110110011111A01A022222001112101112121100211222111111101111101111110111A101111111110010211212202120222220022121212212222
01101101121020001212020201102122010100111111011111111A11A012121221122222001120210101021011111011011111101111111A111111111000222121110222122222022102222222211211
00011110112210212011221211220212022211201111111101111A11A111101101101020222110001201210010111111011111001111111A111111111101121121220222220121202122001202212012
11111111112122121112112120122111120211211111101111101A11A112111012022210122002211111212210110111110111110111010A111111110110200120021121121211212102012221102121
11011011102221120221111121221210110201111011111111111A11A112112011112222012212022121222101011001111011111111111A110110111111122202022212212222210210012202011221
11011111120202100222111122101002221212211111111111110A11A112020222212122212120022111221111101110111110111111101A111111110111212122222111212222011102101122112112
11111011022002110212121102100121111212211111011111111A01A101112100121212202021221111012211111011111111110101101A110101011111101111210222022222201220221111222111
11110111111121122201102012122221221101101100110111011A11A111020211111212201110220111102001011111110011011011011A111011001111112001222212212221001011220211022212
01111101111012211022020101212110222221201111101111110A10A111212111222221212112222212102010111100111111111111111A111111101111022001222212021022202200211002121221
01111111122211111121201012200211101221111111111010011A11A121021012211200211112201112002201111111001111111100110A110111101111220110200112222120011222122122122210
11101111111211221001201011220022121121211111011101110A11A011010000220220211112222002112211110100101101111111011A001111110111122221202222221202220002222112211112
01111111121101212022122212201020211110211011101101011A11A122100110220102122022211211212001110110111111111110111A111111011110211121222221212202121222222222122201
11111111112222121212121022211012201112111111111111111A11A001211122021212010210021011122211111110111111111011111A011110111111111122212222222220212211012211202012
11110110000210102202110212122212102212211111111111111A10A112122111011102202100011121100211111111011101111101110A011110111011012201211202121121221022200202012001
